**-------~~~~~~---------------
*--------~~~~~~---------------
*--------~~~~~~-------***-----
---**----~~~~~~-------***-----
---**----~~~~~~-------***-----
--------^^---------^----------
--------^^^^------^^^---------
----------^^-------^----------
-----~~~~---------------------
-------~-------^----------*---
~~~-----------^^---------***--
~~-----------^^^--------*****-