------------------------------
-~~~~~----------------~~~-----
------------------------------
------------------------------
--~~~-------------------------
------------------------------
------------------------------
------------~~~~~-------------
------------------------------
--~~~~------------------------
-------------------~~~~~------
------------------------------